1111111111111111111111111111111111
1E0000000000000C00000C000000000001
1010010100100000101001000000010101
1010010010101010001001000000010101
1P0000000C00C00000C000000C000000C1
1000100001001000000000001000000001
100000000000C000000000100000C00001
10000010000010000C00000000C0000001
100000001000000C000000100100000001
100100000100000000C0000C0000000001
100000000C00C0C00000000C0000000001
100010000C000000001000000000010001
1000000C0100C000000000100010000001
1000010000001000000000000100000001
1001000001000000C000C0000000010001
100000000000000C000000100000000001
1000010001000000000000000000000001
1001000000001000001000001000000001
100000000C000000100000100000010001
1000001000000000000001000000000001
100000000100100000C000000100000001
100001000000000C000000000000100001
100010000C000000001000000000010001
1000000C0100C000000000100010000001
1000010000001000000000000100000001
1001000001000000C000C0000000010001
100000000000000C000000100000000001
1000010001000000000000000000000001
100001000000000C000000000000100001
1111111111111111111111111111111111
